1
1
1
1                                                                                 1                      
1                                                                                 1                      
1                                                                                 1                      
1                                                                                 1                      
1                                                                                 1                      
1                                                      c            w             1
1                                                                                 1
1                                                                                 1                      
1                            j                                                    1     d                           s
1                                                                      1111       1                      
1                                                111111111111    1111             1                      
1      m                                                                          1                      
1                          111111111111                                           1                                            G
1                                                                                 1                      
1                                                                                 1                      
1                                                                                 1                      
