000000000000000000000000000000000000000000000000000000000000000000000000000000000000000000000000000000000
000000000000000000000000000000000000000000000000000000000000000000000000000000000000000000000000000000000
000000000000000000000000000000000000000000000000000000000000000000000000000000000000000000000000000000000
000000000000000000011111000000001111111110000000000000000000000000000000000000000000000000000000000000000
000000000000000000110000000000001111000000000000000000000000000000000000000000000001111111100000000000000
000000000001111111000000000000000000000000000000000000000000000000000000000000000000000000000000000000000
000000000000000000000000000000000000000000000000000000000000000000000000000000000000000000000000000000000
000000000000000000000000000000000000000000000000011100000000000000000000000000000000000000000000000000000
000000000000000000000000000000000000000000000011111100000000000001111111000000000000000000000000001111111
000000000000000000000000000000000000000000111110000000000000000001110000000000000000000001111100000000000
000000000000000000000000001000000000000000111110000000000000000000000000000000000000000001111100000000000
000000000000000000000000001000000000000000000000000000000000000000000000000000000000000000000000000000000
000000000000011111111000001000000000000000000000000000000000000000000000000000000000000000000000000000000
000000000000000000000000001000000000000000000000000001111111000000000000000000000000000000000000000000000
000000000000000000000000000000000000000000000000000001111111000000000000000000000011111000000000000000000
000000000000000000000000000000000000000000000000000000000000000000000000000000000000000000000000000000000
000000000011110000000000000000000000000000000000000000000000000000000000000000000000000000000000000000000
000000000000000000000000000000000000000000000000000000000000000000000000000000000000000000000000000000000
